8 8
3 3 1 1 1 3 3 3
3 3 1 7 1 1 3 3
3 1 1 0 0 1 1 1
1 1 0 2 0 2 7 1
1 7 0 2 9 1 1 1
1 1 1 1 2 1 3 3
3 3 3 1 7 1 3 3
3 3 3 1 1 1 3 3
DULLRUUDRR