9   9
1 1 1 1 1 1 1 1 1
1 0 0 0 1 0 0 7 1
1 0 2 1 7 1 2 0 1
1 0 0 0 0 0 0 0 1
1 0 0 1 9 1 1 0 1
1 0 0 0 0 0 2 0 1
1 7 0 0 0 0 0 0 1
1 1 1 1 1 1 1 1 1
3 3 3 3 3 3 3 3 3
urrruuldrdddlldluuurrllllluurddddrdlurrrrruuu
