8 8

3 1 1 1 1 1 3 3
3 1 9 0 1 1 1 3
3 1 0 2 0 0 1 3
1 1 1 0 1 0 1 1
1 7 1 0 1 0 0 1
1 7 2 0 0 1 0 1
1 7 0 0 0 2 0 1
1 1 1 1 1 1 1 1

RDRRDDRDDLLULLDLURRRDRRUULUULLDDUURRDDRDDLLLLRRULL