8  8
1 1 1 1 1 1 1 1
1 0 0 7 0 1 1 1
1 0 0 0 0 1 1 1
1 0 1 2 2 7 0 1
1 7 0 0 1 1 0 1
1 9 2 0 1 1 0 1
1 1 1 0 0 0 0 1
1 1 1 1 1 1 1 1
urrudddrrruuulluulldrlldddrururrrdddllluulluuurrrdlulldddrrurlululdd