8 8
3 3 1 1 1 1 1 1
3 3 1 0 0 0 0 1
1 1 1 2 2 2 0 1
1 9 0 2 7 7 0 1
1 0 2 7 7 7 1 1
1 1 1 1 0 0 1 3
3 3 3 1 1 1 1 3
3 3 3 3 3 3 3 3

DRRRURRUULLDDLDLLURRRUULDDUURRRDLULD
