7 7
1 1 1 1 1 1 1
1 7 0 0 0 0 1
1 2 5 0 1 0 1
1 7 0 0 2 5 1
1 0 7 2 0 0 1
1 9 0 5 0 0 1
1 1 1 1 1 1 1
uuudrruurrddlddrullrull