8 8

3 1 1 1 1 1 1 1
3 1 1 1 1 1 1 1
3 1 0 7 2 0 1 1
3 1 0 9 2 0 1 1
3 1 0 0 0 7 1 1
3 1 1 1 1 1 1 1
3 1 1 1 1 1 1 1
3 3 3 3 3 3 3 3
DRRUULDLDR
