9 9
3 3 1 1 1 1 1 3 3
3 1 1 0 2 7 1 1 3
3 1 7 2 0 0 7 1 3
3 1 0 0 0 0 0 1 3
3 1 7 0 0 0 2 1 3
3 1 0 0 2 0 0 1 3
3 1 7 2 9 0 0 1 3
3 1 1 1 1 1 1 1 3
3 3 3 3 3 3 3 3 3
LUUULURURDRDDDDLURRULLURULL